222222222222000000222222222222
222222222222000000222222222222
222222222222000000222222222222
222222222222000000222222222222
222222222222000000222222222222
222222222222000000222222222222
222222222222000000222222222222
222222222222000000222222222222
222222222222000000222222222222
222222222222000000222222222222
222222222222000000222222222222
222222222222000000222222222222
222222222222000000222222222222
222222222222000000222222222222
222222222222000000222222222222
222222222222000000222222222222
222222222222000000222222222222
222222222222000000222222222222
222222222222000000222222222222
222222222222000000222222222222
222222222222000000222222222222
222222222222000000222222222222
222222222222000000222222222222
222222222222000000222222222222
222222222222000000222222222222
222222222222000000222222222222
222222222222000000222222222222
222222222222000000222222222222
222222222222000000222222222222
222222222222000000222222222222
222222222222000000222222222222
222222222222000000222222222222
222222222222000000222222222222
222222222222000000222222222222
222222222222000000222222222222
222222222222000000222222222222
222222222222000000222222222222
222222222222000000222222222222
222222222222000000222222222222
222222222222000000222222222222
222222222222000000222222222222
222222222222000000222222222222
222222222222000000222222222222
222222222222000000222222222222
222222222222000000222222222222
222222222222000000222222222222
222222222222000000222222222222
222222222222000000222222222222
222222222222000000222222222222
222222222222000000222222222222
222222222222000000222222222222
222222222222000000222222222222
222222222222000000222222222222
222222222222000000222222222222
222222222222000000222222222222
222222222222000000222222222222
222222222222000000222222222222
222222222222000000222222222222
222222222222000000222222222222
222222222222000000222222222222
222222222222000000222222222222
222222222220000002222222222222
222222222200000022222222222222
222222222000000222222222222222
222222220000002222222222222222
222222200000022222222222222222
222222000000222222222222222222
222220000002222222222222222222
222200000022222222222222222222
222000000222222222222222222222
220000002222222222222222222222
200000022222222222222222222222
200000022222222222222222222222
200000022222222222222222222222
200000022222222222222222222222
200000022222222222222222222222
200000022222222222222222222222
200000022222222222222222222222
22200f002222222222222222222222222
200000022222222222222222222222
200000022222222222222222222222
200000022222222222222222222222
200000022222222222222222222222
200000022222222222222222222222
200000022222222222222222222222
200000022222222222222222222222
200000022222222222222222222222
200000022222222222222222222222
200000022222222222222222222222
200000022222222222222222222222
200000022222222222222222222222
200000022222222222222222222222
200000022222222222222222222222
200000022222222222222222222222
200000022222222222222222222222
200000022222222222222222222222
200000022222222222222222222222
200000022222222222222222222222
200000022222222222222222222222
200000022222222222222222222222
200000022222222222222222222222
200000022222222222222222222222
200000022222222222222222222222
200000022222222222222222222222
200000022222222222222222222222
200000022222222222222222222222
200000022222222222222222222222
200000022222222222222222222222
200000022222222222222222222222
220000002222222222222222222222
222000000222222222222222222222
222200000022222222222222222222
222220000002222222222222222222
222222000000222222222222222222
222222200000022222222222222222
222222220000002222222222222222
222222222000000222222222222222
222222222200000022222222222222
222222222220000002222222222222
222222222222000000222222222222
222222222222200000022222222222
222222222222220000002222222222
2222222222222222200f0022222222222
222222222222222200000022222222
222222222222222220000002222222
222222222222222222000000222222
222222222222222222200000022222
222222222222222222220000002222
222222222222222222222000000222
222222222222222222222200000022
222222222222222222222220000002
222222222222222222222220000002
222222222222222222222220000002
222222222222222222222220000002
222222222222222222222220000002
222222222222222222222220000002
222222222222222222222220000002
222222222222222222222220000002
222222222222222222222220000002
222222222222222222222220000002
222222222222222222222220000002
222222222222222222222220000002
222222222222222222222220000002
222222222222222222222220000002
222222222222222222222220000002
222222222222222222222220000002
222222222222222222222220000002
222222222222222222222220000002
222222222222222222222220000002
222222222222222222222220000002
222222222222222222222220000002
222222222222222222222220000002
222222222222222222222220000002
222222222222222222222220000002
222222222222222222222220000002
222222222222222222222220000002
222222222222222222222220000002
222222222222222222222220000002
222222222222222222222220000002
222222222222222222222200000022
222222222222222222222000000222
222222222222222222220000002222
222222222222222222200000022222
222222222222222222000000222222
222222222222222220000002222222
222222222222222200000022222222
2222222222222222200f0022222222222
222222222222220000002222222222
222222222222200000022222222222
222222222222000000222222222222
222222222220000002222222222222
222222222200000022222222222222
222222222000000222222222222222
222222220000002222222222222222
222222200000022222222222222222
222222000000222222222222222222
222220000002222222222222222222
222200000022222222222222222222
222000000222222222222222222222
220000002222222222222222222222
200000022222222222222222222222
200000022222222222222222222222
200000022222222222222222222222
200000022222222222222222222222
200000022222222222222222222222
200000022222222222222222222222
200000022222222222222222222222
200000022222222222222222222222
200000022222222222222222222222
200000022222222222222222222222
200000022222222222222222222222
200000022222222222222222222222
200000022222222222222222222222
200000022222222222222222222222
200000022222222222222222222222
220000002222222222222222222222
222000000222222222222222222222
222200000022222222222222222222
222220000002222222222222222222
222222000000222222222222222222
222222222222000000222222222222
222222222222000000222222222222
222222222222000000222222222222
222222222222000000222222222222
222222222222000000222222222222
222222222222000000222222222222
222222222222000000222222222222
222222222222000000222222222222
222222222222000000222222222222
222222222222000000222222222222
222222222222000000222222222222
222222222222000000222222222222
222222222222000000222222222222
222222222222000000222222222222
222222222222000000222222222222
222222222222000000222222222222
222222222222000000222222222222
222222222222000000222222222222
222222222222000000222222222222
222222222222000000222222222222
222222222222000000222222222222
222222222222000000222222222222
222222222222000000222222222222
222222222222000000222222222222
222222222222000000222222222222
222222222222000000222222222222
222222222222000000222222222222
222222222222000000222222222222
222222222222000000222222222222
222222222222000000222222222222
222222222222000000222222222222
222222222222000000222222222222
222222222222000000222222222222
222222222222000000222222222222
222222222222000000222222222222
222222222222000000222222222222
222222222222000000222222222222
222222222222000000222222222222
222222222222000000222222222222