22222222222200000000000222222222222
22222222222200000000000222222222222
22222222222200000000000222222222222
22222222222200000000000222222222222
22222222222200000000000222222222222
22222222222200000000000222222222222
22222222222200000000000222222222222
22222222222200000000000222222222222
22222222222200000000000222222222222
22222222222200000000000222222222222
22222222222200000000000222222222222
22222222222200000000000222222222222
22222222222200000000000222222222222
22222222222200000000000222222222222
22222222222200000000000222222222222
22222222222200000000000222222222222
22222222222200000000000222222222222
22222222222200000000000222222222222
22222222222200000000000222222222222
22222222222200000000000222222222222
22222222222200000000000222222222222
22222222222200000000000222222222222
22222222222200000000000222222222222
22222222222200000000000222222222222
22222222222200000000000222222222222
22222222222200000000000222222222222
22222222222200000000000222222222222
22222222222200000000000222222222222
22222222222200000000000222222222222
22222222222200000000000222222222222
22222222222200000000000222222222222
22222222222200000000000222222222222
22222222222200000000000222222222222
22222222222200000000000222222222222
22222222222200000000000222222222222
22222222222200000000000222222222222
22222222222200000000000222222222222
22222222222200000000000222222222222
22222222222200000000000222222222222
22222222222200000000000222222222222
22222222222200000000000222222222222
22222222222200000000000222222222222
22222222222200000000000222222222222
22222222222200000000000222222222222
22222222222200000000000222222222222
22222222222200000000000222222222222
22222222222200000000000222222222222
22222222222200000000000222222222222
22222222222200000000000222222222222
22222222222200000000000222222222222
22222222222200000000000222222222222
22222222222200000000000222222222222
22222222222200000000000222222222222
22222222222200000000000222222222222
22222222222200000000000222222222222
22222222222200000000000222222222222
22222222222200000000000222222222222
22222222222200000000000222222222222
22222222222200000000000222222222222
22222222222200000000000222222222222
22222222222200000000000222222222222
22222222222000000000002222222222222
22222222220000000000022222222222222
22222222200000000000222222222222222
22222222000000000002222222222222222
22222220000000000022222222222222222
22222200000000000222222222222222222
22222000000000002222222222222222222
22220000000000022222222222222222222
22200000000000222222222222222222222
22000000000002222222222222222222222
20000000000022222222222222222222222
20000000000022222222222222222222222
20000000000022222222222222222222222
20000000000022222222222222222222222
20000000000022222222222222222222222
20000000000022222222222222222222222
20000000000022222222222222222222222
222000f0002222222222222222222222222
20000000000022222222222222222222222
20000000000022222222222222222222222
20000000000022222222222222222222222
20000000000022222222222222222222222
20000000000022222222222222222222222
20000000000022222222222222222222222
20000000000022222222222222222222222
20000000000022222222222222222222222
20000000000022222222222222222222222
20000000000022222222222222222222222
20000000000022222222222222222222222
20000000000022222222222222222222222
20000000000022222222222222222222222
20000000000022222222222222222222222
20000000000022222222222222222222222
20000000000022222222222222222222222
20000000000022222222222222222222222
20000000000022222222222222222222222
20000000000022222222222222222222222
20000000000022222222222222222222222
20000000000022222222222222222222222
20000000000022222222222222222222222
20000000000022222222222222222222222
20000000000022222222222222222222222
20000000000022222222222222222222222
20000000000022222222222222222222222
20000000000022222222222222222222222
20000000000022222222222222222222222
20000000000022222222222222222222222
20000000000022222222222222222222222
22000000000002222222222222222222222
22200000000000222222222222222222222
22220000000000022222222222222222222
22222000000000002222222222222222222
22222200000000000222222222222222222
22222220000000000022222222222222222
22222222000000000002222222222222222
22222222200000000000222222222222222
22222222220000000000022222222222222
22222222222000000000002222222222222
22222222222200000000000222222222222
22222222222220000000000022222222222
22222222222222000000000002222222222
22222222222222222000f00022222222222
22222222222222220000000000022222222
22222222222222222000000000002222222
22222222222222222200000000000222222
22222222222222222220000000000022222
22222222222222222222000000000002222
22222222222222222222200000000000222
22222222222222222222220000000000022
22222222222222222222222000000000002
22222222222222222222222000000000002
22222222222222222222222000000000002
22222222222222222222222000000000002
22222222222222222222222000000000002
22222222222222222222222000000000002
22222222222222222222222000000000002
22222222222222222222222000000000002
22222222222222222222222000000000002
22222222222222222222222000000000002
22222222222222222222222000000000002
22222222222222222222222000000000002
22222222222222222222222000000000002
22222222222222222222222000000000002
22222222222222222222222000000000002
22222222222222222222222000000000002
22222222222222222222222000000000002
22222222222222222222222000000000002
22222222222222222222222000000000002
22222222222222222222222000000000002
22222222222222222222222000000000002
22222222222222222222222000000000002
22222222222222222222222000000000002
22222222222222222222222000000000002
22222222222222222222222000000000002
22222222222222222222222000000000002
22222222222222222222222000000000002
22222222222222222222222000000000002
22222222222222222222222000000000002
22222222222222222222220000000000022
22222222222222222222200000000000222
22222222222222222222000000000002222
22222222222222222220000000000022222
22222222222222222200000000000222222
22222222222222222000000000002222222
22222222222222220000000000022222222
22222222222222222000f00022222222222
22222222222222000000000002222222222
22222222222220000000000022222222222
22222222222200000000000222222222222
22222222222000000000002222222222222
22222222220000000000022222222222222
22222222200000000000222222222222222
22222222000000000002222222222222222
22222220000000000022222222222222222
22222200000000000222222222222222222
22222000000000002222222222222222222
22220000000000022222222222222222222
22200000000000222222222222222222222
22000000000002222222222222222222222
20000000000022222222222222222222222
20000000000022222222222222222222222
20000000000022222222222222222222222
20000000000022222222222222222222222
20000000000022222222222222222222222
20000000000022222222222222222222222
20000000000022222222222222222222222
20000000000022222222222222222222222
20000000000022222222222222222222222
20000000000022222222222222222222222
20000000000022222222222222222222222
20000000000022222222222222222222222
20000000000022222222222222222222222
20000000000022222222222222222222222
20000000000022222222222222222222222
22000000000002222222222222222222222
22200000000000222222222222222222222
22220000000000022222222222222222222
22222000000000002222222222222222222
22222200000000000222222222222222222
22220000000000022222222222222222222
22222000000000002222222222222222222
22222200000000000222222222222222222
22222220000000000022222222222222222
22222222000000000002222222222222222
22222222200000000000222222222222222
22222222220000000000022222222222222
22222222222000000000002222222222222
22222222222200000000000222222222222
22222222222220000000000022222222222
22222222222222000000000002222222222
22222222222222222000f00022222222222
22222222222222220000000000022222222
22222222222222222000000000002222222
22222222222222222200000000000222222
22222222222222222220000000000022222
22222222222222222222000000000002222
22222222222222222222200000000000222
22222222222222222222220000000000022
22222222222222222222222000000000002
22222222222222222222222000000000002
22222222222222222222222000000000002
22222222222222222222222000000000002
22222222222222222222222000000000002
22222222222222222222222000000000002
22222222222222222222222000000000002
22222222222222222222222000000000002
22222222222222222222222000000000002
22222222222222222222222000000000002
22222222222222222222222000000000002
22222222222222222222222000000000002
22222222222222222222222000000000002
22222222222222222222222000000000002
22222222222222222222222000000000002
22222222222222222222222000000000002
22222222222222222222222000000000002
22222222222222222222222000000000002
22222222222222222222222000000000002
22222222222222222222222000000000002
22222222222222222222222000000000002
22222222222222222222222000000000002
22222222222222222222222000000000002
22222222222222222222222000000000002
22222222222222222222222000000000002
22222222222222222222222000000000002
22222222222222222222222000000000002
22222222222222222222222000000000002
22222222222222222222222000000000002
22222222222222222222220000000000022
22222222222222222222200000000000222
22222222222222222222000000000002222
22222222222222222220000000000022222
22222222222222222200000000000222222
22222222222222222000000000002222222
22222222222222220000000000022222222
22222222222222222000f00022222222222
22222222222222000000000002222222222
22222222222220000000000022222222222
22222222222200000000000222222222222
22222222222000000000002222222222222
22222222220000000000022222222222222
22222222222222000000000002222222222
22222222222222222000f00022222222222
22222222222222220000000000022222222
22222222222222222000000000002222222
22222222222222222200000000000222222
22222222222222222220000000000022222
22222222222222222222000000000002222
22222222222222222222200000000000222
22222222222222222222220000000000022
22222222222222222222222000000000002
22222222222222222222222000000000002
22222222222222222222222000000000002
22222222222222222222222000000000002
22222222222222222222222000000000002
22222222222222222222222000000000002
22222222222222222222222000000000002
22222222222222222222222000000000002
22222222222222222222222000000000002
22222222222222222222222000000000002
22222222222222222222222000000000002
22222222222222222222222000000000002
22222222222222222222222000000000002
22222222222222222222222000000000002
22222222222222222222222000000000002
22222222222222222222222000000000002
22222222222222222222222000000000002
22222222222222222222222000000000002
22222222222222222222222000000000002
22222222222222222222222000000000002
22222222222222222222222000000000002
22222222222222222222222000000000002
22222222222222222222222000000000002
22222222222222222222222000000000002
22222222222222222222222000000000002
22222222222222222222222000000000002
22222222222222222222222000000000002
22222222222222222222222000000000002
22222222222222222222222000000000002
22222222222222222222220000000000022
22222222222222222222200000000000222
22222222222222222222000000000002222
22222222222222222220000000000022222
22222222222222222200000000000222222
22222222222222222000000000002222222
22222222222222220000000000022222222
22222222222222222000f00022222222222
22222222222222000000000002222222222
22222222222220000000000022222222222
22222222222200000000000222222222222
22222222222000000000002222222222222
22222222220000000000022222222222222